806/05/2015
80;2C;R1;1;1
80;2C;R2;0;1
80;2C;R3;0;1
80;2D;R1;1;1
80;2D;R2;0;1
80;2D;R3;0;1
80;2E;R1;1;1
80;2E;R2;1;1
80;2E;R3;1;1
80;2F;R1;1;1
80;2F;R2;1;1
80;2F;R3;1;1
47;2C;R1;1;1
47;2D;R1;1;1
47;2E;R1;1;1
47;2F;R1;1;1
95;3C;R1;1;0
95;3D;R1;1;0
96;3C;R1;1;0
96;3D;R1;1;0
